00000000000000000000
01111111011111011110
01000001010001000010
01011111101111110110
01010000011000011100
01010111111111000110
01010010101010011000
01011110101001001111
01000000101011111000
01111011101010000110
01000100100011100010
01010110011100111010
01010101000011101110
01010100111000101000
01110110101111001010
01000011101010011010
01111010101011001010
01010000100001101010
11111111111111111110
00000000000000000000
